#             #
#             #
# ######### ###
#       #     S
####### #######
#     #       #
# #   #       #
# #   #       #
# #   #       #
# ### ###### ##
# #           #
# #############
#             #
#             #
############E##